NO  		textures/mossy.png
WE  textures/greystone.png
EA  textures/wood.png
SO  textures/redbrick.png

	C 35,19,254
F 15,6,40

	111111111111111
111111000111111
111110000011111
11110000001111       111111111
111000N00000111111      11110111
110000000000011       11111111
100001111100 00111     
110000111000011
111000010000111
111100000001111
111110000011111
111111000000001
111111111111111
