
NO      textures/mossy.png
WE      textures/greystone.png
EA 		textures/wood.png
SO 		textures/redbrick.png


C 20,10,150
F 15,6,40

111111111111111111111111111
100000000000000000000000001
100011111111111111111110001
100010000000000000000010001
100010111111111111111010001
100010100000000000001010001
100010100011111111100010001
100010100010000000100010001
100010100010111110100010001
100010100010100010100010001
100010100010100010100010001
100010100010111110100010001
100010100010000000100010001
100010111111111111111010001
100010000000000000000010001
100011110111111111111110001
100000000000000000000000001
111111111111100111111111111
100000000001100100000000001
100000000001100100000000001
100000000001100100000000001
100000000001100100000000001
100000000001100100000000001
100000000001100100000000001
100000000001100100000000001
100000000000000000000000001
100000000000000000000000001
100000000000000000000000001
100000000000000000000000001
100000000000000000000000001
100000000000000000000000001
100000000000N00000000000001
111111111111111111111111111