
NO      textures/mossy.png
WE      textures/greystone.png
EA 		textures/wood.png
SO 		textures/redbrick.png


C 20,10,150
F 15,6,40

111111111111111
1011111000111111
111110000011111
1111000N0001111
111000000000111
110000000000011
1000011111000011111
110000111000011
111000010000111
111100000001111
111110000011111
111111000111111
111111111111111
    1
    1
    1